11111111111111111111111
1C0001100000000000000N1
10001C00100001111111011
1P0N10C0000010011111001
100111110N00100000000N1
10000C00P00010111110011
100N0000P0N000011110011
10011111P0000E011110011
100000111100000000000N1
11111111000N1111000N111
11111111111111111111111