11111111111111111111111
1C00011000011C0000000N1
10001C00100001111111011
1P0N10C0000010011111001
100111110N0010000C000N1
10000C00P00010111110011
100N0000P0N010011110011
10011111P0001E011110011
100000111100011111000N1
1111C111C00N000000CN111
11111111111111111111111