11111111111111111111111
10000110000C00000000001
10000C00100001111111011
1P0000C0000010011111001
10000000000010000000001
10000C00P00010111110011
10000000P00010111110011
10000000P0001E111110011
11111111111111111111111