1111111111111
1000000P00001
10000C0000001
1000000000001
1000000000001
1000000000001
1111111111111
