11111111111111111111111
10000110000000000000001
10000C00100001111111011
1P000000000010011111001
10000000000010000000001
10000000P00010111110011
10000000P00010111110011
10000000P00010111110011
11111111111111111111111