11111111111111111111111
1C00011000011C0000000N1
10001C00100001111111011
100N10C0000010011111001
100111110N0010000C000N1
10000C00000010111110011
100N000000N010011100011
100111110000100E0000011
100000111P00011111000N1
1111C111C00N000000CN111
11111111111111111111111