1111111111111111111111111111111111
1E00000N0000000C00000C00N000000001
1010010100100000101001000000010101
1010010010101010001001000000010101
1P000N000C00C0000000N00000N00000C1
1111111111111111111111111111111111